Location,Date,Sum of retail_and_recreation_percent_change_from_baseline,Sum of grocery_and_pharmacy_percent_change_from_baseline,Sum of parks_percent_change_from_baseline,Sum of transit_stations_percent_change_from_baseline,Sum of workplaces_percent_change_from_baseline,Sum of residential_percent_change_from_baseline,Sum,Inverted_sum
ES,15/2/20,225,-54,1731,521,13,-117,2319,-2319
ES,16/2/20,220,69,1007,560,-26,-128,1702,-1702
ES,17/2/20,-50,106,374,239,251,-51,869,-869
ES,18/2/20,-66,-39,508,131,250,-41,743,-743
ES,19/2/20,-16,-6,818,139,230,-48,1117,-1117
ES,20/2/20,108,53,1107,459,165,-74,1818,-1818
ES,21/2/20,119,32,1538,759,87,-109,2426,-2426
ES,22/2/20,393,79,3396,1216,198,-157,5125,-5125
ES,23/2/20,782,829,2589,1439,167,-214,5592,-5592
ES,24/2/20,413,254,2664,596,-614,-28,3285,-3285
ES,25/2/20,-49,-263,1486,292,-705,58,819,-819
ES,26/2/20,-61,155,752,158,-152,1,853,-853
ES,27/2/20,216,411,952,486,34,-66,2033,-2033
ES,28/2/20,103,-332,2181,392,-485,-2,1857,-1857
ES,29/2/20,158,303,1193,499,-16,-43,2094,-2094
ES,1/3/20,231,250,262,601,115,-92,1367,-1367
ES,2/3/20,-169,144,-486,153,17,29,-312,312
ES,3/3/20,-162,71,-100,-65,215,-12,-53,53
ES,4/3/20,-21,172,641,99,195,-25,1061,-1061
ES,5/3/20,-86,48,89,62,62,10,185,-185
ES,6/3/20,-113,16,-86,63,-44,29,-135,135
ES,7/3/20,57,7,1009,210,57,-41,1299,-1299
ES,8/3/20,310,249,1226,616,119,-102,2418,-2418
ES,9/3/20,-90,225,716,175,225,-51,1200,-1200
ES,10/3/20,-83,872,1181,56,193,-64,2155,-2155
ES,11/3/20,-184,908,1439,-127,84,-21,2099,-2099
ES,12/3/20,-626,1599,278,-518,-85,65,713,-713
ES,13/3/20,-2006,1827,-1269,-1583,-801,395,-3437,3437
ES,14/3/20,-4156,-617,-2601,-2814,-1768,776,-11180,11180
ES,15/3/20,-5453,-3343,-4614,-4246,-2933,993,-19596,19596
ES,16/3/20,-5028,-2117,-4328,-4272,-3044,1271,-17518,17518
ES,17/3/20,-5192,-2560,-4336,-4472,-3445,1403,-18602,18602
ES,18/3/20,-5224,-2404,-4286,-4582,-3561,1453,-18604,18604
ES,19/3/20,-5496,-3882,-4589,-4911,-4286,1771,-21393,21393
ES,20/3/20,-5445,-2595,-4762,-4904,-3929,1867,-19768,19768
ES,21/3/20,-5759,-3496,-5325,-5094,-3828,1569,-21933,21933
ES,22/3/20,-5892,-4805,-5488,-5329,-4019,1335,-24198,24198
ES,23/3/20,-5300,-2928,-4566,-4871,-3826,1543,-19948,19948
ES,24/3/20,-5404,-3273,-4613,-4852,-3960,1611,-20491,20491
ES,25/3/20,-5432,-3331,-4621,-4946,-3995,1660,-20665,20665
ES,26/3/20,-5450,-3364,-4659,-4898,-4041,1708,-20704,20704
ES,27/3/20,-5525,-3226,-4858,-5090,-4022,1928,-20793,20793
ES,28/3/20,-5778,-3720,-5290,-5107,-3880,1569,-22206,22206
ES,29/3/20,-5894,-4954,-5471,-5307,-3925,1313,-24238,24238
ES,30/3/20,-5560,-3499,-4811,-5094,-4389,1739,-21614,21614
ES,31/3/20,-5822,-3513,-4941,-5093,-4534,1822,-22081,22081
ES,1/4/20,-5820,-3420,-4855,-5076,-4505,1847,-21829,21829
ES,2/4/20,-5783,-3361,-4839,-5090,-4513,1892,-21694,21694
ES,3/4/20,-5599,-3165,-4941,-5173,-4446,2080,-21244,21244
ES,4/4/20,-5792,-3648,-5309,-5201,-3972,1600,-22322,22322
ES,5/4/20,-5928,-4949,-5510,-5354,-4148,1363,-24526,24526
ES,6/4/20,-5457,-3243,-4712,-5052,-4410,1742,-21132,21132
ES,7/4/20,-5559,-2649,-4677,-4992,-4434,1734,-20577,20577
ES,8/4/20,-5503,-2072,-4586,-4950,-4426,1690,-19847,19847
ES,9/4/20,-5855,-4710,-5066,-5270,-5276,2107,-24070,24070
ES,10/4/20,-6050,-5790,-5398,-5586,-5527,2508,-25843,25843
ES,11/4/20,-5799,-2933,-5264,-5037,-3862,1565,-21330,21330
ES,12/4/20,-5948,-4676,-5471,-5425,-4061,1355,-24226,24226
ES,13/4/20,-5626,-4036,-4720,-5082,-4532,1794,-22202,22202
ES,14/4/20,-5443,-2748,-4432,-4804,-3990,1581,-19836,19836
ES,15/4/20,-5501,-3025,-4591,-4861,-4012,1671,-20319,20319
ES,16/4/20,-5486,-3075,-4536,-4866,-4015,1700,-20278,20278
ES,17/4/20,-5566,-3038,-4706,-4969,-3974,1914,-20339,20339
ES,18/4/20,-5810,-3482,-5194,-5162,-3676,1543,-21781,21781
ES,19/4/20,-5927,-4744,-5462,-5289,-3946,1339,-24029,24029
ES,20/4/20,-5418,-3402,-4414,-4812,-3882,1566,-20362,20362
ES,21/4/20,-5434,-3167,-4536,-4836,-3888,1601,-20260,20260
ES,22/4/20,-5417,-2947,-4382,-4853,-3866,1603,-19862,19862
ES,23/4/20,-5514,-3638,-4473,-5007,-4196,1742,-21086,21086
ES,24/4/20,-5502,-2844,-4558,-4934,-3887,1851,-19874,19874
ES,25/4/20,-5766,-3335,-5164,-5191,-3585,1522,-21519,21519
ES,26/4/20,-5764,-4201,-4807,-5147,-3744,1277,-22386,22386
ES,27/4/20,-5275,-3089,-3850,-4583,-3713,1498,-19012,19012
ES,28/4/20,-5280,-2881,-3738,-4571,-3762,1497,-18735,18735
ES,29/4/20,-5265,-2607,-3726,-4585,-3726,1528,-18381,18381
ES,30/4/20,-5146,-1891,-3730,-4537,-3726,1493,-17537,17537
ES,1/5/20,-5878,-5558,-4541,-5346,-5294,2369,-24248,24248
ES,2/5/20,-5288,-1975,-2675,-3924,-3177,1268,-15771,15771
ES,3/5/20,-5211,-2511,-2620,-3988,-3115,1045,-16400,16400
ES,4/5/20,-4683,-2124,-1400,-3672,-3385,1246,-14018,14018
ES,5/5/20,-4701,-2020,-1215,-3636,-3389,1246,-13715,13715
ES,6/5/20,-4714,-2046,-1137,-3681,-3369,1284,-13663,13663
ES,7/5/20,-4749,-2082,-1494,-3795,-3387,1320,-14187,14187
ES,8/5/20,-4937,-2186,-2298,-3980,-3330,1540,-15191,15191
ES,9/5/20,-5270,-2402,-3098,-4053,-2827,1245,-16405,16405
ES,10/5/20,-5425,-3308,-3826,-4522,-3088,1126,-19043,19043
ES,11/5/20,-4076,-1686,-1022,-3243,-2968,1066,-11929,11929
ES,12/5/20,-4317,-1824,-1915,-3551,-3038,1171,-13474,13474
ES,13/5/20,-4262,-1718,-1366,-3446,-3035,1178,-12649,12649
ES,14/5/20,-4415,-1855,-2467,-3810,-3086,1267,-14366,14366
ES,15/5/20,-4444,-1700,-2195,-3741,-3062,1412,-13730,13730
ES,16/5/20,-4701,-1864,-2305,-3530,-2316,1010,-13706,13706
ES,17/5/20,-4590,-2130,-1860,-3626,-2216,789,-13633,13633
ES,18/5/20,-3524,-1399,327,-2913,-2691,927,-9273,9273
ES,19/5/20,-3551,-1334,361,-2935,-2719,930,-9248,9248
ES,20/5/20,-3500,-1233,210,-3015,-2718,973,-9283,9283
ES,21/5/20,-3498,-1155,-60,-3041,-2755,1003,-9506,9506
ES,22/5/20,-3664,-1166,-687,-3223,-2611,1115,-10236,10236
ES,23/5/20,-4022,-1385,-1307,-3078,-1666,743,-10715,10715
ES,24/5/20,-4067,-1728,-1462,-3433,-1611,585,-11716,11716
ES,25/5/20,-2643,-980,644,-2644,-2487,792,-7318,7318
ES,26/5/20,-2693,-972,1009,-2652,-2380,781,-6907,6907
ES,27/5/20,-2693,-916,1096,-2595,-2363,795,-6676,6676
ES,28/5/20,-2663,-802,982,-2624,-2385,808,-6684,6684
ES,29/5/20,-2855,-810,429,-2781,-2300,876,-7441,7441
ES,30/5/20,-3172,-998,80,-2497,-954,428,-7113,7113
ES,31/5/20,-3530,-1373,-1037,-3189,-918,412,-9635,9635
ES,1/6/20,-2224,-820,1028,-2404,-2240,707,-5953,5953
ES,2/6/20,-2263,-700,1087,-2337,-2131,689,-5655,5655
ES,3/6/20,-2373,-670,279,-2452,-2143,748,-6611,6611
ES,4/6/20,-2432,-659,-507,-2584,-2201,808,-7575,7575
ES,5/6/20,-2249,-662,505,-2523,-2011,756,-6184,6184
ES,6/6/20,-2693,-895,-193,-2389,-727,408,-6489,6489
ES,7/6/20,-3215,-1281,-1289,-3144,-786,433,-9282,9282
ES,8/6/20,-1765,-616,274,-2258,-2009,644,-5730,5730
ES,9/6/20,-1830,-821,899,-2245,-2053,630,-5420,5420
ES,10/6/20,-1731,-537,1152,-2136,-1980,601,-4631,4631
ES,11/6/20,-2014,-1075,-168,-2606,-2265,748,-7380,7380
ES,12/6/20,-2040,-598,-486,-2647,-2011,762,-7020,7020
ES,13/6/20,-2186,-820,383,-2231,-387,318,-4923,4923
ES,14/6/20,-2483,-959,239,-2710,-130,210,-5833,5833
ES,15/6/20,-1409,-584,1360,-2068,-1823,529,-3995,3995
ES,16/6/20,-1549,-602,666,-2199,-1846,594,-4936,4936
ES,17/6/20,-1484,-515,1308,-2034,-1828,566,-3987,3987
ES,18/6/20,-1416,-526,1373,-2087,-1851,543,-3964,3964
ES,19/6/20,-1634,-584,1248,-2222,-1760,527,-4425,4425
ES,20/6/20,-1976,-732,1646,-1950,-168,139,-3041,3041
ES,21/6/20,-2000,-330,1279,-2232,90,-4,-3197,3197
ES,22/6/20,-928,-266,2782,-1554,-1853,345,-1474,1474
ES,23/6/20,-872,58,3356,-1453,-1829,242,-498,498
ES,24/6/20,-1539,-1371,3156,-1926,-2466,503,-3643,3643
ES,25/6/20,-968,-39,1946,-1577,-1813,377,-2074,2074
ES,26/6/20,-1143,-80,2088,-1550,-1737,357,-2065,2065
ES,27/6/20,-1406,-358,2778,-1152,-303,18,-423,423
ES,28/6/20,-1583,2,1779,-1598,346,-125,-1179,1179
ES,29/6/20,-652,-310,3022,-1336,-1768,275,-769,769
ES,30/6/20,-652,-130,3098,-1380,-1617,254,-427,427
ES,1/7/20,-691,-84,2647,-1233,-1692,267,-786,786
ES,2/7/20,-636,70,2392,-1268,-1739,293,-888,888
ES,3/7/20,-855,-23,2707,-1296,-1660,250,-877,877
ES,4/7/20,-1186,-332,3448,-929,-144,-62,795,-795
ES,5/7/20,-1146,781,2364,-1285,318,-211,821,-821
ES,6/7/20,-391,60,3538,-1034,-1762,213,624,-624
ES,7/7/20,-534,-140,4280,-1042,-1785,203,982,-982
ES,8/7/20,-643,-124,3883,-1115,-1693,231,539,-539
ES,9/7/20,-608,-68,3606,-1125,-1726,236,315,-315
ES,10/7/20,-936,-162,3007,-1255,-1678,238,-786,786
ES,11/7/20,-1269,-445,3538,-846,-77,-50,851,-851
ES,12/7/20,-1304,289,2032,-1175,350,-161,31,-31
ES,13/7/20,-369,-17,4570,-982,-1734,185,1653,-1653
ES,14/7/20,-523,-100,4339,-1076,-1752,208,1096,-1096
ES,15/7/20,-505,-37,4027,-1069,-1647,205,974,-974
ES,16/7/20,-504,-120,3960,-1113,-1737,227,713,-713
ES,17/7/20,-978,-164,3559,-1266,-1688,241,-296,296
ES,18/7/20,-1325,-452,3907,-869,-71,-48,1142,-1142
ES,19/7/20,-1328,175,2621,-1189,378,-190,467,-467
ES,20/7/20,-409,80,4656,-1030,-1688,206,1815,-1815
ES,21/7/20,-564,-68,4527,-1189,-1713,246,1239,-1239
ES,22/7/20,-560,-87,4827,-1140,-1676,240,1604,-1604
ES,23/7/20,-556,-35,4771,-1134,-1701,222,1567,-1567
ES,24/7/20,-943,10,4102,-1233,-1662,239,513,-513
ES,25/7/20,-1417,-966,4371,-838,-250,-23,877,-877
ES,26/7/20,-1189,391,3081,-1074,494,-204,1499,-1499
ES,27/7/20,-349,198,5312,-987,-1843,197,2528,-2528
ES,28/7/20,-466,19,4894,-1122,-1807,245,1763,-1763
ES,29/7/20,-449,71,5162,-1044,-1793,221,2168,-2168
ES,30/7/20,-456,86,4651,-1100,-1858,218,1541,-1541
ES,31/7/20,-905,-306,4029,-1234,-1950,248,-118,118
ES,1/8/20,-1070,-94,3750,-588,-160,-33,1805,-1805
ES,2/8/20,-891,785,3234,-914,386,-137,2463,-2463
ES,3/8/20,272,700,6684,-676,-2107,208,5081,-5081
ES,4/8/20,58,391,7342,-840,-2118,226,5059,-5059
ES,5/8/20,5,272,7590,-886,-2151,216,5046,-5046
ES,6/8/20,-46,338,7159,-918,-2156,234,4611,-4611
ES,7/8/20,-651,47,5347,-1183,-2085,278,1753,-1753
ES,8/8/20,-1000,-210,5002,-504,-227,-36,3025,-3025
ES,9/8/20,-702,760,4014,-792,365,-171,3474,-3474
ES,10/8/20,432,783,7720,-618,-2313,228,6232,-6232
ES,11/8/20,94,443,6975,-946,-2348,312,4530,-4530
ES,12/8/20,213,498,7081,-934,-2297,325,4886,-4886
ES,13/8/20,197,491,7761,-813,-2298,274,5612,-5612
ES,14/8/20,-449,744,6052,-1050,-2283,311,3325,-3325
ES,15/8/20,-1481,-2555,5231,-680,-1171,104,-552,552
ES,16/8/20,-525,1208,4030,-653,386,-155,4291,-4291
ES,17/8/20,302,1119,3889,-899,-2346,292,2357,-2357
ES,18/8/20,99,551,4497,-983,-2213,318,2269,-2269
ES,19/8/20,-198,214,4333,-1117,-2254,328,1306,-1306
ES,20/8/20,-189,272,4495,-1108,-2271,330,1529,-1529
ES,21/8/20,-767,61,3587,-1280,-2207,428,-178,178
ES,22/8/20,-1168,-396,3607,-906,-297,53,893,-893
ES,23/8/20,-917,283,2658,-1007,475,-120,1372,-1372
ES,24/8/20,-128,322,3796,-1032,-2070,288,1176,-1176
ES,25/8/20,-337,122,4166,-1139,-2049,294,1057,-1057
ES,26/8/20,-428,59,3835,-1166,-1969,325,656,-656
ES,27/8/20,-449,70,3469,-1206,-1998,327,213,-213
ES,28/8/20,-921,-67,2627,-1414,-1980,434,-1321,1321
ES,29/8/20,-1302,-360,1659,-1229,-357,164,-1425,1425
ES,30/8/20,-1175,119,1533,-1239,405,-32,-389,389
ES,31/8/20,-303,189,2243,-1018,-1799,286,-402,402
ES,1/9/20,-498,100,2340,-1043,-1677,268,-510,510
ES,2/9/20,-599,-45,2709,-1086,-1638,285,-374,374
ES,3/9/20,-609,-15,2732,-1124,-1665,279,-402,402
ES,4/9/20,-954,-182,2266,-1267,-1591,272,-1456,1456
ES,5/9/20,-1244,-307,2265,-1082,-190,48,-510,510
ES,6/9/20,-1215,255,1456,-1272,509,-59,-326,326
ES,7/9/20,-352,274,1981,-1041,-1792,257,-673,673
ES,8/9/20,-768,-715,2205,-1281,-2138,326,-2371,2371
ES,9/9/20,-631,127,2050,-1049,-1532,265,-770,770
ES,10/9/20,-553,163,2324,-968,-1576,205,-405,405
ES,11/9/20,-1009,-372,3257,-1356,-1773,233,-1020,1020
ES,12/9/20,-1254,-330,3118,-1133,-163,-26,212,-212
ES,13/9/20,-1380,45,1880,-1363,592,-132,-358,358
ES,14/9/20,-550,72,2518,-1093,-1383,170,-266,266
ES,15/9/20,-773,-223,2671,-1177,-1405,215,-692,692
ES,16/9/20,-897,-213,2314,-1189,-1322,215,-1092,1092
ES,17/9/20,-1044,-298,1408,-1332,-1444,255,-2455,2455
ES,18/9/20,-1417,-435,358,-1533,-1373,341,-4059,4059
ES,19/9/20,-1538,-381,658,-1594,-221,224,-2852,2852
ES,20/9/20,-1692,-286,482,-1639,413,125,-2597,2597
ES,21/9/20,-841,-151,1688,-1101,-1385,237,-1553,1553
ES,22/9/20,-1063,-183,1634,-1004,-1300,258,-1658,1658
ES,23/9/20,-1275,-113,1026,-984,-1242,324,-2264,2264
ES,24/9/20,-1298,-135,594,-1044,-1312,352,-2843,2843
ES,25/9/20,-1494,-102,143,-1112,-1216,351,-3430,3430
ES,26/9/20,-1660,-235,397,-1291,-158,286,-2661,2661
ES,27/9/20,-1930,-177,9,-1383,353,199,-2929,2929
ES,28/9/20,-1071,39,951,-784,-1033,275,-1623,1623
ES,29/9/20,-1169,-69,1205,-873,-1073,270,-1709,1709
ES,30/9/20,-1247,101,981,-787,-1042,242,-1752,1752
ES,1/10/20,-1314,252,211,-877,-941,253,-2416,2416
ES,2/10/20,-1730,-65,-1282,-951,-1005,375,-4658,4658
ES,3/10/20,-1605,23,-465,-1116,-271,287,-3147,3147
ES,4/10/20,-2133,45,-1230,-1518,28,279,-4529,4529
ES,5/10/20,-1084,216,642,-467,-984,218,-1459,1459
ES,6/10/20,-1178,140,780,-555,-930,216,-1527,1527
ES,7/10/20,-1278,26,834,-731,-879,251,-1777,1777
ES,8/10/20,-1104,237,1142,-559,-869,211,-942,942
ES,9/10/20,-1293,-18,1523,-580,-1199,272,-1295,1295
ES,10/10/20,-1451,270,1386,-972,-276,197,-846,846
ES,11/10/20,-1182,1050,1704,-1593,-43,189,125,-125
ES,12/10/20,-1900,-3340,3483,-1849,-4214,797,-7023,7023
ES,13/10/20,-1314,628,406,-587,-986,253,-1600,1600
ES,14/10/20,-1477,202,-121,-803,-830,350,-2679,2679
ES,15/10/20,-1459,82,-83,-828,-886,357,-2817,2817
ES,16/10/20,-1679,146,141,-842,-775,350,-2659,2659
ES,17/10/20,-1971,-199,325,-1247,-321,356,-3057,3057
ES,18/10/20,-2316,-141,32,-1518,-85,284,-3744,3744
ES,19/10/20,-1590,-28,264,-804,-820,323,-2655,2655
ES,20/10/20,-1924,-313,-924,-1193,-905,417,-4842,4842
ES,21/10/20,-1746,-47,-298,-966,-798,414,-3441,3441
ES,22/10/20,-1838,-96,-836,-996,-887,454,-4199,4199
ES,23/10/20,-1806,240,-222,-937,-788,418,-3095,3095
ES,24/10/20,-2171,-185,-270,-1437,-568,443,-4188,4188
ES,25/10/20,-2692,-239,-1633,-2078,-553,428,-6767,6767
ES,26/10/20,-1652,51,-466,-913,-864,392,-3452,3452
ES,27/10/20,-1771,54,-308,-1005,-873,403,-3500,3500
ES,28/10/20,-1791,68,-3,-981,-816,419,-3104,3104
ES,29/10/20,-1677,254,205,-829,-892,374,-2565,2565
ES,30/10/20,-2051,281,-192,-1173,-938,500,-3573,3573
ES,31/10/20,-2409,-4,-367,-1782,-728,528,-4762,4762
ES,1/11/20,-2572,148,-525,-2325,-774,450,-5598,5598
ES,2/11/20,-2199,-1408,561,-1735,-2630,728,-6683,6683
ES,3/11/20,-1873,230,-684,-1132,-959,417,-4001,4001
ES,4/11/20,-2066,-25,-1350,-1463,-954,541,-5317,5317
ES,5/11/20,-1994,-23,-1308,-1470,-1002,543,-5254,5254
ES,6/11/20,-2457,35,-1352,-1663,-998,644,-5791,5791
ES,7/11/20,-3042,-230,-1787,-2372,-1211,789,-7853,7853
ES,8/11/20,-3338,-400,-1258,-2452,-1238,598,-8088,8088
ES,9/11/20,-2111,-34,-171,-1281,-1040,481,-4156,4156
ES,10/11/20,-2360,-109,-60,-1366,-1006,483,-4418,4418
ES,11/11/20,-2467,-151,-268,-1427,-1044,538,-4819,4819
ES,12/11/20,-2427,-8,-186,-1368,-1076,521,-4544,4544
ES,13/11/20,-2651,83,-520,-1549,-1147,651,-5133,5133
ES,14/11/20,-3101,-312,-1353,-2313,-1300,741,-7638,7638
ES,15/11/20,-3450,-499,-1405,-2447,-1407,606,-8602,8602
ES,16/11/20,-2304,-225,-53,-1273,-974,459,-4370,4370
ES,17/11/20,-2360,-175,238,-1338,-992,463,-4164,4164
ES,18/11/20,-2412,-134,92,-1373,-959,497,-4289,4289
ES,19/11/20,-2417,-64,-534,-1370,-1022,517,-4890,4890
ES,20/11/20,-2606,112,-694,-1457,-1000,609,-5036,5036
ES,21/11/20,-2899,-206,-755,-2002,-1200,645,-6417,6417
ES,22/11/20,-3248,-204,-844,-2136,-1339,526,-7245,7245
ES,23/11/20,-2140,-168,-277,-1268,-922,438,-4337,4337
ES,24/11/20,-2168,-118,-340,-1349,-930,450,-4455,4455
ES,25/11/20,-2296,-83,-999,-1478,-931,518,-5269,5269
ES,26/11/20,-2271,31,-1366,-1508,-990,549,-5555,5555
ES,27/11/20,-2292,195,-1347,-1543,-1015,637,-5365,5365
ES,28/11/20,-2553,36,-1259,-1935,-1052,649,-6114,6114
ES,29/11/20,-2800,623,-1358,-2138,-1122,542,-6253,6253
ES,30/11/20,-1836,67,-221,-1138,-860,404,-3584,3584
ES,1/12/20,-1941,137,-324,-1195,-854,410,-3767,3767
ES,2/12/20,-2009,194,-699,-1242,-818,453,-4121,4121
ES,3/12/20,-1945,295,-757,-1148,-939,456,-4038,4038
ES,4/12/20,-2251,289,-1758,-1453,-1048,640,-5581,5581
ES,5/12/20,-2503,131,-1909,-2037,-1051,642,-6727,6727
ES,6/12/20,-2605,1618,-1817,-2682,-1251,568,-6169,6169
ES,7/12/20,-1855,-618,-473,-2506,-3729,1013,-8168,8168
ES,8/12/20,-3187,-3594,-884,-2922,-4591,1335,-13843,13843
ES,9/12/20,-1783,902,-958,-1207,-876,408,-3514,3514
ES,10/12/20,-1897,362,-1339,-1457,-937,511,-4757,4757
ES,11/12/20,-2144,189,-1572,-1644,-866,612,-5425,5425
ES,12/12/20,-2148,36,-1037,-1813,-740,552,-5150,5150
ES,13/12/20,-2189,1370,-976,-2031,-776,440,-4162,4162
ES,14/12/20,-1476,18,-714,-1211,-794,365,-3812,3812
ES,15/12/20,-1420,171,-269,-1128,-800,348,-3098,3098
ES,16/12/20,-1585,149,-766,-1248,-779,414,-3815,3815
ES,17/12/20,-1464,386,-403,-1116,-851,388,-3060,3060
ES,18/12/20,-1737,209,-821,-1205,-855,478,-3931,3931
ES,19/12/20,-2085,18,-1508,-1590,-758,533,-5390,5390
ES,20/12/20,-1808,2414,-1020,-1758,-652,411,-2413,2413
ES,21/12/20,-805,1004,198,-838,-1070,331,-1180,1180
ES,22/12/20,-784,1194,676,-646,-1299,323,-536,536
ES,23/12/20,-597,2329,392,-572,-2011,422,-37,37
ES,24/12/20,-1404,1066,-233,-1990,-3229,702,-5088,5088
ES,25/12/20,-4422,-4962,-1608,-3994,-4985,1513,-18458,18458
ES,26/12/20,-2345,-725,-713,-1802,-1478,609,-6454,6454
ES,27/12/20,-2081,1675,-1305,-2099,-976,464,-4322,4322
ES,28/12/20,-984,736,-389,-1719,-2529,712,-4173,4173
ES,29/12/20,-999,1020,-30,-1701,-2540,678,-3572,3572
ES,30/12/20,-801,2207,264,-1368,-2456,613,-1541,1541
ES,31/12/20,-1606,1007,-619,-2301,-3277,783,-6013,6013
ES,1/1/21,-4601,-5124,-2058,-4177,-5044,1621,-19383,19383
ES,2/1/21,-2197,-294,-1205,-1825,-1338,663,-6196,6196
ES,3/1/21,-1919,1904,-1411,-2010,-814,493,-3757,3757
ES,4/1/21,-561,1282,-146,-1499,-2331,623,-2632,2632
ES,5/1/21,-526,1862,235,-1483,-2392,577,-1727,1727
ES,6/1/21,-3379,-4385,-1067,-3030,-4630,1255,-15236,15236
ES,7/1/21,-2027,305,-1686,-1912,-2170,821,-6669,6669
ES,8/1/21,-2716,-260,-2396,-2408,-2066,1069,-8777,8777
ES,9/1/21,-3427,-1158,-2636,-2884,-1846,1030,-10921,10921
ES,10/1/21,-3463,-514,-2666,-2928,-1684,785,-10470,10470
ES,11/1/21,-2063,188,-1325,-1583,-1494,656,-5621,5621
ES,12/1/21,-2208,-57,-1239,-1606,-1426,610,-5926,5926
ES,13/1/21,-2464,-138,-1261,-1724,-1316,559,-6344,6344
ES,14/1/21,-2615,-337,-1681,-1969,-1494,578,-7518,7518
ES,15/1/21,-2956,-411,-1900,-2142,-1536,690,-8255,8255
ES,16/1/21,-3323,-732,-1812,-2526,-1647,716,-9324,9324
ES,17/1/21,-3673,-887,-2023,-2921,-1810,630,-10684,10684
ES,18/1/21,-2503,-469,-1095,-1805,-1443,499,-6816,6816
ES,19/1/21,-2752,-575,-1214,-1983,-1501,528,-7497,7497
ES,20/1/21,-3051,-908,-2154,-2268,-1580,684,-9277,9277
ES,21/1/21,-3010,-573,-1893,-2152,-1535,669,-8494,8494
ES,22/1/21,-3404,-685,-2466,-2450,-1609,874,-9740,9740
ES,23/1/21,-3792,-884,-2914,-3079,-1837,935,-11571,11571
ES,24/1/21,-3988,-946,-2332,-3109,-1998,753,-11620,11620
ES,25/1/21,-2932,-624,-1900,-2081,-1440,600,-8377,8377
ES,26/1/21,-2951,-555,-1230,-1998,-1441,568,-7607,7607
ES,27/1/21,-3070,-538,-862,-1971,-1424,618,-7247,7247
ES,28/1/21,-2998,-396,-684,-1946,-1487,597,-6914,6914
ES,29/1/21,-3274,-331,-1038,-2197,-1545,758,-7627,7627
ES,30/1/21,-3777,-661,-2446,-3089,-1825,909,-10889,10889
ES,31/1/21,-4067,-839,-2432,-3167,-2057,763,-11799,11799
ES,1/2/21,-2838,-339,-930,-1999,-1340,528,-6918,6918
ES,2/2/21,-2945,-488,-761,-2073,-1465,554,-7178,7178
ES,3/2/21,-2960,-309,-809,-1994,-1338,567,-6843,6843
ES,4/2/21,-3028,-302,-1264,-2102,-1387,594,-7489,7489
ES,5/2/21,-3300,-207,-1679,-2245,-1368,738,-8061,8061
ES,6/2/21,-3765,-549,-2503,-3000,-1819,893,-10743,10743
ES,7/2/21,-3970,-720,-2218,-3022,-2018,731,-11217,11217
ES,8/2/21,-2841,-415,-1513,-1988,-1294,537,-7514,7514
ES,9/2/21,-2989,-512,-1790,-2133,-1314,586,-8152,8152
ES,10/2/21,-2834,-206,-961,-1951,-1224,556,-6620,6620
ES,11/2/21,-2769,-159,-837,-1846,-1284,546,-6349,6349
ES,12/2/21,-2970,-9,-1200,-1933,-1244,666,-6690,6690
ES,13/2/21,-3076,-136,-663,-2300,-1472,624,-7023,7023
ES,14/2/21,-3064,87,-535,-2269,-1509,489,-6801,6801
ES,15/2/21,-2368,-152,164,-1702,-1721,507,-5272,5272
ES,16/2/21,-2636,-562,73,-1771,-1769,557,-6108,6108
ES,17/2/21,-2551,-93,-25,-1548,-1201,482,-4936,4936
ES,18/2/21,-2547,-18,-410,-1524,-1174,481,-5192,5192
ES,19/2/21,-2741,111,-302,-1623,-1162,566,-5151,5151
ES,20/2/21,-3040,-318,-595,-2242,-1392,572,-7015,7015
ES,21/2/21,-3639,-688,-2420,-2715,-1686,603,-10545,10545
ES,22/2/21,-2353,-94,-517,-1475,-1033,417,-5055,5055
ES,23/2/21,-2324,-81,317,-1407,-1008,373,-4130,4130
ES,24/2/21,-2363,-30,174,-1395,-974,409,-4179,4179
ES,25/2/21,-2333,177,-471,-1391,-1040,429,-4629,4629
ES,26/2/21,-2412,354,-308,-1417,-1065,475,-4373,4373
ES,27/2/21,-2579,45,-24,-1849,-1153,424,-5136,5136
ES,28/2/21,-2826,210,-556,-1956,-1254,339,-6043,6043
ES,1/3/21,-2182,-261,-408,-1528,-1433,433,-5379,5379
ES,2/3/21,-2097,195,-131,-1302,-959,341,-3953,3953
ES,3/3/21,-2037,250,235,-1171,-896,342,-3277,3277
ES,4/3/21,-2027,330,22,-1162,-939,348,-3428,3428
ES,5/3/21,-2262,278,-355,-1326,-998,448,-4215,4215
ES,6/3/21,-2449,-28,-481,-1802,-1094,426,-5428,5428
ES,7/3/21,-2861,4,-1352,-2095,-1204,389,-7119,7119
ES,8/3/21,-1861,58,-619,-1293,-1002,361,-4356,4356
ES,9/3/21,-1907,104,-120,-1269,-890,313,-3769,3769
ES,10/3/21,-1876,148,390,-1131,-832,319,-2982,2982
ES,11/3/21,-1887,195,-19,-1165,-892,343,-3425,3425
ES,12/3/21,-2056,335,-79,-1213,-838,383,-3468,3468
ES,13/3/21,-2200,-65,314,-1553,-994,327,-4171,4171
ES,14/3/21,-2400,309,-171,-1783,-1041,251,-4835,4835
ES,15/3/21,-1711,206,511,-1053,-793,258,-2582,2582
ES,16/3/21,-1774,142,534,-1143,-827,268,-2800,2800
ES,17/3/21,-1778,292,471,-1063,-787,296,-2569,2569
ES,18/3/21,-1657,840,-327,-1064,-894,304,-2798,2798
ES,19/3/21,-2345,-1049,-894,-2055,-2073,755,-7661,7661
ES,20/3/21,-2279,74,-773,-1928,-1092,452,-5546,5546
ES,21/3/21,-2385,229,-292,-1687,-963,267,-4831,4831
ES,22/3/21,-1730,240,500,-1084,-777,270,-2581,2581
ES,23/3/21,-1724,155,1130,-1009,-795,221,-2022,2022
ES,24/3/21,-1703,274,1040,-968,-792,259,-1890,1890
ES,25/3/21,-1550,546,1020,-717,-873,245,-1329,1329
ES,26/3/21,-1866,441,377,-1011,-1069,368,-2760,2760
ES,27/3/21,-2026,183,755,-1220,-811,252,-2867,2867
ES,28/3/21,-1977,623,1309,-1435,-796,116,-2160,2160
ES,29/3/21,-1215,569,2350,-1095,-1751,319,-823,823
ES,30/3/21,-1169,829,2596,-1078,-1770,296,-296,296
ES,31/3/21,-731,2016,3150,-640,-1795,176,2176,-2176
ES,1/4/21,-1556,-363,4099,-1955,-3973,694,-3054,3054
ES,2/4/21,-2908,-3566,3442,-2770,-4577,1217,-9162,9162
ES,3/4/21,-1872,793,1676,-1453,-1306,268,-1894,1894
ES,4/4/21,-1853,1136,1533,-1075,-801,46,-1014,1014
ES,5/4/21,-1507,-221,3140,-908,-2342,413,-1425,1425
ES,6/4/21,-1491,864,932,-919,-1092,249,-1457,1457
ES,7/4/21,-1576,688,801,-1006,-1024,304,-1813,1813
ES,8/4/21,-1592,526,676,-1036,-1025,318,-2133,2133
ES,9/4/21,-2021,266,-581,-1394,-1006,461,-4275,4275
ES,10/4/21,-2260,134,-1127,-1880,-895,456,-5572,5572
ES,11/4/21,-2563,79,-1388,-1997,-1011,397,-6483,6483
ES,12/4/21,-1538,294,966,-965,-847,244,-1846,1846
ES,13/4/21,-1728,303,289,-1088,-739,265,-2698,2698
ES,14/4/21,-1790,306,386,-1045,-744,301,-2586,2586
ES,15/4/21,-1810,265,-85,-1113,-790,346,-3187,3187
ES,16/4/21,-1952,396,62,-1136,-708,357,-2981,2981
ES,17/4/21,-2125,101,115,-1621,-822,336,-4016,4016
ES,18/4/21,-2207,504,386,-1516,-817,206,-3444,3444
ES,19/4/21,-1612,295,681,-932,-640,241,-1967,1967
ES,20/4/21,-1691,291,334,-1001,-681,272,-2476,2476
ES,21/4/21,-1749,354,107,-1072,-727,333,-2754,2754
ES,22/4/21,-1595,643,169,-870,-715,293,-2075,2075
ES,23/4/21,-1979,-507,1094,-1242,-1536,489,-3681,3681
ES,24/4/21,-2102,240,-41,-1605,-875,357,-4026,4026
ES,25/4/21,-2575,107,-1412,-1985,-984,349,-6500,6500
ES,26/4/21,-1584,390,-116,-1005,-692,303,-2704,2704
ES,27/4/21,-1658,338,-43,-1071,-673,298,-2809,2809
ES,28/4/21,-1617,382,117,-1042,-710,324,-2546,2546
ES,29/4/21,-1496,663,-142,-926,-689,302,-2288,2288
ES,30/4/21,-1448,1713,91,-845,-757,290,-956,956
ES,1/5/21,-2708,-3367,612,-1657,-2062,483,-8699,8699
ES,2/5/21,-1007,3728,286,-1045,-331,55,1686,-1686
ES,3/5/21,-1206,993,1024,-755,-1015,267,-692,692
ES,4/5/21,-1314,724,1402,-649,-636,187,-286,286
ES,5/5/21,-1346,684,1199,-717,-602,212,-570,570
ES,6/5/21,-1298,681,1170,-653,-650,214,-536,536
ES,7/5/21,-1480,629,1303,-709,-584,208,-633,633
ES,8/5/21,-1664,168,1638,-1064,-672,105,-1489,1489
ES,9/5/21,-2197,330,-1138,-1634,-879,229,-5289,5289
ES,10/5/21,-1263,586,305,-708,-678,218,-1540,1540
ES,11/5/21,-1209,566,985,-639,-649,203,-743,743
ES,12/5/21,-1219,671,704,-545,-637,215,-811,811
ES,13/5/21,-1209,559,436,-592,-810,248,-1368,1368
ES,14/5/21,-1120,792,1650,-306,-721,134,429,-429
ES,15/5/21,-1298,202,1853,-602,-877,68,-654,654
ES,16/5/21,-1596,815,823,-808,-715,7,-1474,1474
ES,17/5/21,-1061,275,2127,-347,-920,166,240,-240
ES,18/5/21,-1122,599,1432,-443,-620,167,13,-13
ES,19/5/21,-1080,662,1767,-536,-559,162,416,-416
ES,20/5/21,-920,762,2013,-635,-580,141,781,-781
ES,21/5/21,-1061,798,1665,-432,-568,130,532,-532
ES,22/5/21,-1297,242,1766,-701,-610,98,-502,502
ES,23/5/21,-1711,817,257,-1031,-698,94,-2272,2272
ES,24/5/21,-847,632,1918,-435,-798,184,654,-654
ES,25/5/21,-904,759,1951,-406,-551,145,994,-994
ES,26/5/21,-931,799,1862,-441,-533,151,907,-907
ES,27/5/21,-828,837,1651,-356,-578,152,878,-878
ES,28/5/21,-834,944,2088,-190,-529,78,1557,-1557
ES,29/5/21,-1057,384,2502,-332,-531,-24,942,-942
ES,30/5/21,-1245,1325,1661,-568,-503,-76,594,-594
ES,31/5/21,-721,540,2197,-333,-845,138,976,-976
ES,1/6/21,-754,1044,1368,-308,-601,175,924,-924
ES,2/6/21,-550,1201,2333,-156,-565,123,2386,-2386
ES,3/6/21,-761,576,1827,-383,-949,220,530,-530
ES,4/6/21,-698,1138,2005,-176,-600,112,1781,-1781
ES,5/6/21,-1043,451,1878,-395,-546,62,407,-407
ES,6/6/21,-1089,1542,2003,-339,-423,-103,1591,-1591
ES,7/6/21,-408,1051,2827,9,-594,80,2965,-2965
ES,8/6/21,-493,1002,2841,-26,-606,91,2809,-2809
ES,9/6/21,-540,921,2894,-109,-741,121,2546,-2546
ES,10/6/21,-418,1122,2799,-6,-690,84,2891,-2891
ES,11/6/21,-769,822,2550,-78,-768,48,1805,-1805
ES,12/6/21,-1048,316,3071,-134,-606,-111,1488,-1488
ES,13/6/21,-1267,1388,1882,-299,-555,-204,945,-945
ES,14/6/21,-537,919,2477,-19,-833,77,2084,-2084
ES,15/6/21,-555,896,2790,-26,-743,84,2446,-2446
ES,16/6/21,-578,964,2204,-122,-812,102,1758,-1758
ES,17/6/21,-696,842,1049,-287,-943,166,131,-131
ES,18/6/21,-853,686,1657,-268,-905,86,403,-403
ES,19/6/21,-1189,205,1745,-353,-727,-13,-332,332
ES,20/6/21,-1329,1472,724,-515,-727,-50,-425,425
ES,21/6/21,-378,889,2648,-47,-1101,79,2090,-2090
ES,22/6/21,-422,886,2796,-46,-1117,83,2180,-2180
ES,23/6/21,-335,1075,3574,77,-1233,24,3182,-3182
ES,24/6/21,-489,65,4751,-197,-2063,177,2244,-2244